1000000100111111 
1000000110011111
1100100000000011
0001110110110000
1000100100000001
1110000000000010
1000000100000110
0101100000001000
1011000001000011
1000100100111111
0111110110000001
1110000000000111
1000100100011111
0110110110000101
0100110100110000
0110100100000101
0011110100110000
0111100100000101
1100110000000100
0010110100110000
1101000000010010
0110110110000101
0000000000000000
0001000100110000
1111111000000000